######
#. *R#
#    #
#* *.#
L* *.#
######